111111111111111111111111
11111P000000000000000111
1111C0000010000000000011
111000000000000000000001
110000001000C00000000011
1000A0000000000000000111
110000000000000010001111
111C00000000000000011111
111101000000C00000001111
110000001000000000000011
111000000000000000000001
1111000000000000000000E1
111111111111111111111111