11111111111111111111
10011000000000000001
1000C000001000000001
10000000000000000001
100000001000C0000001
1000A000000000000001
10000000000000001001
100C0000000000000001
100001000000CP000011
100000001000000000E1
11111111111111111111