111111111111
1P00C00000E1
10C000C00001
111111111111