11111111111111111111
10000001000000000001
1000C000000000000001
10000000010000000001
100000000000C0000001
10000000000000000001
10000000000010000001
100C0000000000000001
1000010000000C000001
1P0000000000100000E1
11111111111111111111
