11111111111111111111
100000000000000000P1
1000C000000000000001
10000000000000000001
10000000000000C00001
1E000000000000000001
11111111111111111111
